697,697,697,697,697,697,697,697,697,697,697,697,697,697,697,697,697,697,697,697,697,697,697,697,697,697,697,697,697,697,697,697,697,697,697,697,697,697,697,697,697,697,697,697,697,697,697,697,697,697,697,697,697,697,697,697,697,697,697,697,697,697,697,697,697,697,697,697,697,697,697,697,697,697,697,697,697,697,697,697,697,697,697,697,697,697,697,697,697,697,697,697,697,697,697,697,697,697,697,697,697,697,697,697,697,697,697,697,697,697,697,697,697,697,697,697,697,697,697,697,697,697,697,697,697,697,697,697,697,697,697,697,697,697,697,697,697,697,697,697,697,697,697,697,697,697,697,697,697,697,697,697,697,697,697,697,697,697,697,697,697,697,697,697,697,697,697,697,697,697,697,697,697,697,697,697,697,697,697,697,697,697,697,697,697,697,697,697,697,697,697,697,697,697,697,697,697,697,697,697,697,697,697,697,697,697,697,697,697,697,697,697,697,697,697,697,697,697,697,697,697,697,697,697,697,697,697,697,697,697,697,697,697,697,697,697,697,697,697,697,697,697,697,697,697,697,697,697,697,697,
697,697,697,697,697,697,697,697,697,697,697,697,697,697,697,697,697,697,697,697,697,697,697,697,697,697,697,697,697,697,697,697,697,697,697,697,697,697,697,697,697,697,697,697,697,697,697,697,697,697,697,697,697,697,697,697,697,697,697,697,697,697,697,697,697,697,697,697,697,697,697,697,697,697,697,697,697,697,697,697,697,697,697,697,697,697,697,697,697,697,697,697,697,697,697,697,697,697,697,697,697,697,697,697,697,697,697,697,697,697,697,697,697,697,697,697,697,697,697,697,697,697,697,697,697,697,697,697,697,697,697,697,697,697,697,697,697,697,697,697,697,697,697,697,697,697,697,697,697,697,697,697,697,697,697,697,697,697,697,697,697,697,697,697,697,697,697,697,697,697,697,697,697,697,697,697,697,697,697,697,697,697,697,697,697,697,697,697,697,697,697,697,697,697,697,697,697,697,697,697,697,697,697,697,697,697,697,697,697,697,697,697,697,697,697,697,697,697,697,697,697,697,697,697,697,697,697,697,697,697,697,697,697,697,697,697,697,697,697,697,697,697,697,697,697,697,697,697,697,697,
697,697,697,697,697,697,697,697,697,697,697,763,697,697,697,697,697,697,697,661,662,663,697,697,697,697,697,697,697,697,697,697,697,697,697,697,661,662,662,663,697,697,697,697,697,697,697,697,697,697,697,697,697,697,697,697,697,697,697,697,697,697,697,697,697,697,697,661,662,663,697,697,697,697,697,697,697,697,697,697,697,697,697,697,697,661,662,662,663,697,697,697,697,697,697,697,697,697,697,697,697,697,697,697,697,697,697,697,697,697,697,697,697,697,697,697,661,662,663,697,697,697,697,697,697,697,697,697,697,697,697,697,697,661,662,662,663,697,697,697,697,697,697,697,697,697,697,697,697,697,697,697,697,697,697,697,697,697,697,697,697,697,697,697,661,662,663,697,697,697,697,697,697,697,697,697,697,697,697,697,697,661,662,662,663,697,697,697,697,697,697,697,697,697,697,697,697,697,697,281,697,697,697,697,697,697,697,697,697,697,697,697,697,697,697,697,697,697,697,697,697,697,697,697,697,697,697,697,697,697,697,697,697,697,697,697,697,697,697,697,697,697,697,697,697,697,697,697,697,697,
697,697,763,697,763,763,697,697,697,697,697,697,697,697,697,697,697,763,697,694,695,696,697,697,697,697,697,661,662,662,662,663,697,697,697,697,694,695,695,696,697,697,697,697,697,697,697,697,697,697,697,697,697,697,697,697,661,662,663,697,697,697,697,697,697,697,697,694,695,696,697,697,697,697,697,697,661,662,662,662,663,697,697,697,697,694,695,695,696,697,697,697,697,697,697,697,697,697,697,697,697,697,697,697,697,661,662,663,697,697,697,697,697,697,697,697,694,695,696,697,697,697,697,697,661,662,662,662,663,697,697,697,697,694,695,695,696,697,697,697,697,697,697,697,697,697,697,697,697,697,697,697,697,661,662,663,697,697,697,697,697,697,697,697,694,695,696,697,697,697,697,697,661,662,662,662,663,697,697,697,697,694,695,695,696,697,697,697,697,697,697,697,697,697,697,697,697,697,697,314,697,661,662,663,697,697,697,697,697,697,697,697,697,697,697,697,697,697,697,697,697,697,697,697,697,697,697,697,697,697,697,697,697,697,697,697,697,697,697,697,697,697,697,697,697,697,697,697,697,697,
697,697,763,697,697,697,697,697,697,697,697,697,697,763,697,697,697,697,697,697,697,763,697,697,697,697,697,694,695,695,695,696,697,697,697,697,697,697,697,697,697,697,697,697,697,697,697,697,697,697,697,697,697,697,697,697,694,695,696,697,697,697,697,697,697,697,697,697,697,697,697,697,697,697,697,697,694,695,695,695,696,697,697,697,697,697,697,697,697,697,697,697,697,697,697,697,697,697,697,697,697,697,697,697,697,694,695,696,697,697,932,697,697,697,697,697,697,697,697,697,697,697,697,697,694,695,695,695,696,697,697,932,697,697,697,697,697,697,697,697,697,697,697,697,697,697,697,697,697,697,697,697,697,694,695,696,697,697,697,697,697,697,697,697,697,697,697,697,697,697,697,697,694,695,695,695,696,697,697,697,697,697,697,697,697,697,697,697,697,697,697,697,697,697,697,697,697,697,697,314,697,694,695,696,697,697,697,697,697,697,697,697,697,697,697,697,697,697,697,697,697,697,697,697,697,697,697,697,697,697,697,697,697,697,697,697,697,697,697,697,697,697,697,697,697,697,697,697,697,697,
697,697,763,697,697,697,697,697,763,697,697,697,697,763,697,697,697,697,697,697,697,763,25,697,697,697,697,697,697,697,697,697,697,697,697,697,697,697,697,697,697,697,697,697,697,697,697,697,697,697,697,697,697,697,697,697,697,697,697,697,697,697,697,697,697,697,697,697,697,697,697,697,697,697,697,697,697,697,697,697,697,2,2,2,2,2,2,2,2,697,697,697,2,2,2,25,697,697,697,697,697,697,697,697,697,697,697,697,697,697,25,697,697,697,697,697,697,697,697,697,697,697,2,2,2,697,697,697,697,2,25,25,2,697,697,697,697,697,697,697,697,697,697,697,697,697,697,697,697,697,697,697,697,697,697,697,697,697,697,697,697,697,697,697,697,697,697,697,697,697,697,697,697,697,697,697,697,697,697,697,697,697,697,697,697,697,697,697,697,34,34,697,697,697,697,697,697,697,697,314,697,697,697,697,697,697,697,697,697,697,697,697,697,697,697,697,697,697,697,697,697,697,697,697,697,697,697,697,697,697,697,697,697,697,697,697,697,697,697,697,697,697,697,697,697,697,697,697,697,697,
697,697,763,697,697,697,697,697,697,697,697,697,697,697,697,697,697,697,697,697,697,763,697,697,697,697,697,697,697,697,697,697,697,697,697,697,697,697,697,697,697,697,697,697,697,697,697,697,697,697,697,697,697,697,697,697,697,697,697,697,697,697,697,697,697,697,697,697,697,697,697,697,697,697,697,697,697,697,697,697,697,697,697,697,697,697,697,697,697,697,697,697,697,697,697,697,697,697,697,697,697,697,697,697,697,697,697,697,697,697,697,697,697,697,697,697,697,697,697,697,697,697,697,697,697,697,697,697,697,697,697,697,697,697,697,697,697,697,697,697,697,697,697,697,697,697,697,697,697,697,697,697,697,697,697,697,697,697,697,697,697,697,697,697,697,697,697,697,697,697,697,697,697,697,697,697,697,697,697,697,697,697,697,697,697,697,697,697,34,34,34,697,697,697,697,697,697,697,697,314,697,697,697,697,697,697,697,697,697,697,697,697,697,697,697,697,697,697,697,697,697,697,697,697,697,697,697,697,697,697,697,697,697,697,697,697,697,697,697,697,697,697,697,697,697,697,697,697,697,697,
697,697,763,697,697,697,763,697,763,763,763,763,697,763,763,697,763,697,763,763,763,763,697,697,697,697,697,697,697,697,697,697,697,697,697,697,697,697,697,697,697,697,697,697,697,697,697,697,697,697,697,697,697,697,697,697,697,697,697,697,697,697,697,697,697,697,697,697,697,697,697,697,697,697,697,697,697,697,697,697,697,697,697,697,697,697,697,697,697,697,697,697,697,697,697,697,697,697,697,697,697,697,697,697,697,697,697,697,697,697,697,697,697,697,697,697,697,697,697,697,697,697,697,697,697,697,697,697,697,697,697,697,697,697,697,697,697,697,697,697,697,697,697,697,697,697,697,697,697,697,697,697,697,697,697,697,697,697,697,697,697,697,697,697,697,697,697,697,697,697,697,697,697,697,697,697,697,697,697,697,697,697,697,697,697,697,697,34,34,34,34,697,697,697,697,697,697,697,697,314,697,697,697,697,697,697,697,697,697,697,697,697,697,697,697,697,697,697,697,697,697,697,697,697,697,697,697,697,697,697,697,697,697,697,697,697,697,697,697,697,697,697,697,697,697,697,697,697,697,697,
697,697,697,697,697,697,697,697,697,697,697,697,697,697,697,697,697,697,697,697,697,932,697,697,697,697,697,697,697,697,697,697,697,697,697,697,697,697,697,697,697,697,697,697,697,697,697,697,697,697,697,697,697,697,697,697,697,697,697,697,697,697,697,697,697,697,697,697,697,697,697,697,697,697,697,697,697,697,697,697,697,697,697,697,697,697,697,697,697,697,697,697,697,697,697,697,697,697,697,697,697,697,697,697,697,697,697,697,697,697,697,697,697,697,697,697,697,697,697,697,697,697,697,697,697,697,697,697,697,697,697,697,697,697,697,697,697,697,697,697,697,697,697,697,697,697,697,697,697,697,697,697,697,697,697,697,697,697,697,697,697,697,697,697,697,697,697,697,697,697,697,697,697,697,697,697,697,697,697,697,697,697,697,697,697,697,34,34,34,34,34,697,697,697,697,697,697,697,697,314,697,697,697,697,697,12,12,12,697,697,697,697,697,697,697,697,697,697,697,697,697,697,697,697,697,697,697,697,697,697,697,697,697,697,697,697,697,697,697,697,697,697,697,697,697,697,697,697,697,697,
697,697,697,697,697,697,697,697,697,697,697,697,697,697,697,697,25,697,697,697,2,25,2,25,2,697,697,697,697,697,697,697,697,697,697,697,697,697,697,697,697,697,697,697,697,697,265,266,697,697,697,697,697,697,697,697,697,265,266,697,697,697,697,697,697,697,697,697,697,697,697,697,697,697,697,697,697,697,2,25,2,697,697,697,697,697,697,697,697,697,697,697,697,697,697,2,697,697,697,697,697,2,2,697,697,697,697,25,697,697,25,697,697,25,697,697,697,697,697,2,697,697,697,697,697,697,697,697,697,697,2,2,697,697,697,697,697,697,34,697,697,34,697,697,697,697,697,697,697,697,697,697,697,34,697,697,34,697,697,697,697,697,697,697,697,697,697,697,697,2,2,25,2,697,697,697,697,697,697,697,697,697,697,697,697,34,34,34,34,34,34,697,697,697,697,697,697,697,697,314,697,697,697,697,697,13,14,15,697,697,697,697,697,697,697,697,697,697,697,697,697,697,697,265,266,697,697,697,697,697,697,697,697,697,697,697,697,697,697,697,697,697,697,697,697,697,697,697,697,697,
697,697,697,697,697,697,697,697,697,697,697,697,697,697,697,697,697,697,697,697,697,697,697,697,697,697,697,697,697,697,697,697,697,697,697,697,763,673,265,266,697,697,697,697,697,697,298,299,697,697,274,697,697,697,697,697,697,298,299,697,697,697,697,697,697,697,697,697,697,697,697,697,697,697,697,697,697,697,697,697,697,697,697,697,697,697,697,697,697,697,697,697,697,697,697,697,697,697,697,274,697,697,697,697,697,697,697,697,697,697,697,697,697,697,697,697,697,697,697,697,697,697,697,697,697,697,697,697,697,697,697,697,697,697,697,697,697,34,34,697,697,34,34,697,697,697,697,274,697,697,697,697,34,34,697,697,34,34,697,697,697,697,697,697,697,697,697,697,697,697,697,697,697,697,697,697,697,697,697,697,697,697,697,697,34,34,34,34,34,34,34,697,697,697,697,274,697,697,697,314,697,697,697,697,12,45,45,45,12,697,697,697,697,697,697,697,697,697,697,697,697,697,697,298,299,697,697,697,697,697,697,697,697,697,697,697,697,697,697,697,697,697,697,697,697,697,697,697,697,697,
697,697,697,697,697,697,697,697,697,697,697,697,697,697,697,697,697,274,697,697,697,697,697,697,697,697,697,697,265,266,697,697,697,697,697,697,697,697,298,299,697,697,697,697,697,697,298,299,697,273,306,275,697,697,697,697,697,298,299,697,697,697,697,697,697,274,697,697,697,697,697,697,697,697,697,697,697,697,697,697,697,697,697,697,697,697,697,697,697,697,697,697,697,697,697,697,697,697,273,306,275,697,697,697,697,697,697,697,697,697,697,697,697,697,274,697,697,697,697,697,697,697,697,697,697,697,697,697,697,697,697,697,697,697,697,697,34,34,34,697,697,34,34,34,697,697,273,306,275,697,697,34,34,34,697,697,34,34,34,697,697,697,274,697,265,266,697,697,697,697,697,697,697,697,697,697,697,697,697,697,265,266,697,34,34,34,34,34,34,34,34,697,697,697,273,306,275,697,697,314,697,697,697,697,14,14,46,14,14,697,697,274,697,697,697,697,697,697,697,697,697,267,268,269,299,697,697,697,697,697,697,697,697,697,697,697,697,697,697,697,697,697,697,697,697,697,697,697,697,697,
697,697,697,697,697,697,697,697,697,697,697,309,310,310,310,311,273,306,275,697,697,697,697,309,310,311,697,930,298,299,697,697,697,697,697,697,697,930,298,299,930,309,310,310,311,763,298,299,273,306,307,306,275,697,697,697,930,298,299,309,310,310,310,311,273,306,275,697,697,697,697,309,310,311,697,697,697,697,697,697,697,697,697,697,697,697,697,697,697,697,309,310,310,311,697,697,697,273,306,307,306,275,697,697,697,930,697,697,309,310,310,310,311,273,306,275,697,697,930,697,309,310,311,697,697,697,697,697,697,697,697,697,697,697,930,34,34,34,34,310,310,34,34,34,34,273,306,307,306,341,34,34,34,34,697,697,34,34,34,34,311,273,306,275,298,299,930,697,309,310,311,697,697,697,697,697,697,697,697,697,298,299,34,34,34,34,34,34,34,34,34,697,697,273,306,307,308,275,697,34,697,697,697,697,14,14,47,14,14,377,273,306,275,697,697,697,697,697,697,697,697,300,301,302,299,697,697,697,697,697,697,697,697,697,697,697,697,697,697,697,697,697,697,697,697,697,697,697,697,697,
1,1,1,1,1,1,1,1,1,1,1,1,1,1,1,1,1,1,1,1,1,1,1,1,1,1,1,1,1,1,1,1,1,1,1,1,1,1,1,1,1,1,1,1,1,1,1,1,1,1,1,1,1,1,1,1,1,1,1,1,1,1,1,1,1,1,1,1,1,697,697,1,1,1,1,1,1,1,1,1,1,1,1,1,1,1,1,697,697,697,1,1,1,1,1,1,1,1,1,1,1,1,1,1,1,1,1,1,1,1,1,1,1,1,1,1,1,1,1,1,1,1,1,1,1,1,1,1,1,1,1,1,1,1,1,1,1,1,1,1,1,1,1,1,1,1,1,1,1,1,1,1,1,1,697,697,1,1,1,1,1,1,1,1,1,1,1,1,1,1,1,1,1,1,1,1,1,1,1,1,1,1,1,1,1,1,1,1,1,1,1,1,1,1,1,1,1,1,1,1,1,1,1,1,1,1,1,1,1,1,1,1,1,1,1,1,1,1,1,1,1,1,1,1,1,1,1,1,1,1,1,1,1,1,1,1,1,1,1,1,1,1,1,1,1,1,1,1,1,1